███████████████████████████████
█                  █          █
█ ███████████ ████████ ██████ █
█ █                         █ █
█ █ ███████████████████████ █ █
█ █ █                     █ █ █
█ █ █ ███ ███████████████   █ █
█ █ █ █        █        █ █ █ █
█ █ █ █ ███████████████ █ █ █ █
█ █ █ █ █       █     █ █ █ █ █
█ █ █ █ █ █████ █████ █ █ █ █ █
█ █ █ █ █ █         █ █ █ █ █ █
█ █ █ █ █ █ ███ ███ █ █ █ █ █ █
█ █   █ █ █ █     █ █ █ █ █ █ █
█ █ █ █ █ █ █ █ █ █ █ █ █ ███ █
█ █ █ ███           █   █ █ █ █
█ █ █ █ █ ███ █ █ █ █ █ █ █   █
█   █ █ █ █ █     █ █ █ █ █ █ █
█ █ █ █ █ █ ███ ███ █ █ █ █ █ █
█ █ █   █ █         █ █ █ █ █ █
█ █ █ █ █ ███████████ █ █ █ █ █
█ █ █ █ █             █   █ █ █
█ █ █ █ ███████ █████████ █ █ █
█ █ █ █                 █ █ ███
█ █ █ ███████████████████ █ █ █
█ █ █                     █ █ █
█ █ ███████████████████████ █ █
███   █                     █ █
█ ████████ ██████████████████ █
█                             █
█████████████████████████████ █