███████████████████████████████
█                    █        █
█ ███████████ ████████ ██████ █
█ █         █               █ █
█ █ ███████████████████████ █ █
█ █ █                     █ █ █
█ ███ ███ ███████████████ █ █ █
█     █        █        █ █ █ █
█ ███ █ ███████████ ███ █ █ █ █
█ █ █ █ █       █     █ █ █ █ █
█ █ █ █ █ █████ █████ █ █ █ █ █
█ █ █ █ █ █         █ █ █ █ █ █
█ █ █ █ █ █ ███████ █ █ █ █ █ █
█ █ █ █ █ █ █     █ █ █ █ █ █ █
█ █ █ █ █ ███     █ █ █ █ █ █ █
█ █ █ ███         █   █ █ █ █ █
█   █ █ █ ███     █ █ █ █ █   █
█ █ █ █ █ █ █     █ █ █ █ ███ █
█ █ ███ █ █ ███████ █ █ █ █ █ █
█ █ █   █ █         █ █ █ █ █ █
█ █ █ █ █ ███████████ █ █ █ █ █
███ █ █ █       █     █   █ █ █
█ █ █ █ ███████ █████████ █ █ █
█ █ █ █                 █ █ █ █
█ █ █ ███████████████████ █ █ █
█ █ █                     █ █ █
    ████████████ ██████████ █ █
███   █                     █ █
█ ████████ ██████████████████ █
█                             █
███████████████████████████████
