██████████████████████ ████████
█                       █     █
█ ████████████████████████ ██ █
█ █                         █ █
█ █ ███████████████████████ █ █
█ █ █           █         █ █ █
█   █ ███ ███████████████   █ █
█ █ █ █             █   █ █ █ █
█ █ █ █ ███████████ ███ █ █ █ █
█ █ █ █ █       █     █ █ █ █ █
█ █ █ █ █ █████ █████ █ █ █ █ █
█ ███ █ █ █   █     █ █ █ █ █ █
█ █ █ █ █ █ ███████ █ █ █ █ █ █
█ █   █     █     █ █   █ █ █ █
█ █ █ █ █████ ███ █ ███ █ ███ █
█ █ █ ███     █ █ █ █ █ █ █ █ █
█ █ █   █ █ █ █ █ █ █ █ █ █   █
█ █ █ █ █ █ █ █   █ █ █ █ █ █ █
███ █ █ █ █ ███████ █ █ █ █ █ █
█ █ █ █ █ █         █ █ █ █ █ █
█ █ █ █ █ ███████████ █ █ █ █ █
█ █ █ █ █             █   █ █ █
█ █ █ █ ███████ █████████ █ █ █
█ █ █ █                 █ █ ███
█ █ █ ███████████████████ █ █ █
█ █ █                   █ █ █ █
█ █ ███████████████████████ █ █
█ █                         █ █
█ ████████ ██████████████████ █
█                             █
███████████████████████████████
